

0,0,0,0,0,0
0,0,4,0,0,0
0,0,1,0,0,0
0,0,1,0,0,0
0,0,1,0,0,0
0,0,23,1,21,0
0,0,0,0,1,0
0,0,3,1,22,0
0,0,0,0,0,0