
0,0,0,0,0,0,0,0,0
0,0,0,0,4,0,0,0,0
0,0,0,0,5,0,0,0,0
0,0,0,0,5,0,0,0,0
0,0,0,0,5,0,0,0,0
0,0,0,0,5,0,0,0,0
0,0,0,0,5,0,0,0,0
0,0,0,0,5,0,0,0,0
0,0,0,0,5,0,0,0,0
0,0,0,0,5,0,0,0,0
0,0,0,0,5,0,0,0,0
0,0,0,0,1,0,0,0,0
0,0,0,0,1,0,0,0,0
0,0,0,0,1,1,0,0,0
0,0,0,1,0,1,0,0,0
0,20,1,1,0,23,1,21,0
0,1,0,0,0,0,0,1,0
0,1,0,0,0,0,0,1,0
0,1,0,0,0,0,0,1,0
0,1,0,20,3,21,0,1,0
0,1,0,1,0,1,0,1,0
0,1,0,1,0,1,0,1,0
0,1,0,1,0,1,0,1,0
0,23,1,22,0,23,1,22,0
0,0,0,0,0,0,0,0,0

