0,0,0,0,0,0,0,0,0
0,0,0,0,4,0,0,0,0
0,0,0,0,5,0,0,0,0
0,0,0,0,5,0,0,0,0
0,0,0,0,5,0,0,0,0
0,0,0,0,5,0,0,0,0
0,0,0,0,5,0,0,0,0
0,0,0,0,1,0,0,0,0
0,0,0,0,1,0,0,0,0
0,0,0,0,1,1,21,0,0
0,0,0,3,1,1,22,0,0
0,0,0,0,0,0,0,0,0