 , , , , ,0,0,0,0,0,0
 , , , , ,0,4,61,61,71,0
 , , , , ,0,0,0, ,6, 
 , , , , , , , , ,6, 
 , , , , , , , , ,6,
 , , , , , , , , ,6, 
 , , , , , , , , ,6, 
 , , , , , , , , ,6, 
 , , , , , , , , ,6, 
 , , , , , , , , ,6, 
 , , , , , , , , ,6, 
 , , , , , , , , ,6, 
 , , , , , , , , ,6, 
 , , , , , , , , ,6, 
 , , , , , , , , ,6, 
0,0,0,0,0,0,0,0,0,1,0
0,0,0,20,1,1,1,0,0,1,0
0,0,0,1,0,0,1,0,0,1,0
0,0,0,1,0,0,1,0,20,1,0
0,0,0,1,0,0,1,0,1,0,0
0,0,0,1,0,0,1,0,1,0,0
0,0,0,1,0,0,1,0,1,0,0
0,0,0,1,0,0,1,0,1,0,0
0,0,0,1,0,0,1,1,1,0,0
0,3,1,1,0,0,0,0,0,0,0
0,0,0,0,0,0,0,0,0,0,0
